"filename", "language", "TypeScript", "HTML", "SCSS", "JavaScript", "SQL", "comment", "blank", "total"
"/Users/darrellparkhouse/projects/angular/kaylios/client/src/app/app-routing.module.ts", "TypeScript", 8, 0, 0, 0, 0, 0, 0, 8
"/Users/darrellparkhouse/projects/angular/kaylios/client/src/app/app.module.ts", "TypeScript", 15, 0, 0, 0, 0, 0, 0, 15
"/Users/darrellparkhouse/projects/angular/kaylios/client/src/app/contact-me/contact-me.component.html", "HTML", 0, 24, 0, 0, 0, 5, 0, 29
"/Users/darrellparkhouse/projects/angular/kaylios/client/src/app/contact-me/contact-me.component.ts", "TypeScript", 7, 0, 0, 0, 0, 0, 0, 7
"/Users/darrellparkhouse/projects/angular/kaylios/client/src/app/global-styles/_typography.scss", "SCSS", 0, 0, 6, 0, 0, 0, 0, 6
"/Users/darrellparkhouse/projects/angular/kaylios/client/src/app/header/header.component.html", "HTML", 0, 1, 0, 0, 0, 0, 0, 1
"/Users/darrellparkhouse/projects/angular/kaylios/client/src/app/models/note.ts", "TypeScript", 7, 0, 0, 0, 0, 0, 0, 7
"/Users/darrellparkhouse/projects/angular/kaylios/client/src/app/models/portfolio-item.ts", "TypeScript", 2, 0, 0, 0, 0, 0, 1, 3
"/Users/darrellparkhouse/projects/angular/kaylios/client/src/app/notes/add-note/add-note.component.html", "HTML", 0, 22, 0, 0, 0, 0, 3, 25
"/Users/darrellparkhouse/projects/angular/kaylios/client/src/app/notes/add-note/add-note.component.scss", "SCSS", 0, 0, 44, 0, 0, 1, 6, 51
"/Users/darrellparkhouse/projects/angular/kaylios/client/src/app/notes/add-note/add-note.component.spec.ts", "TypeScript", 17, 0, 0, 0, 0, 0, 5, 22
"/Users/darrellparkhouse/projects/angular/kaylios/client/src/app/notes/add-note/add-note.component.ts", "TypeScript", 15, 0, 0, 0, 0, 0, 4, 19
"/Users/darrellparkhouse/projects/angular/kaylios/client/src/app/notes/edit-note/edit-note.component.html", "HTML", 0, 1, 0, 0, 0, 0, 1, 2
"/Users/darrellparkhouse/projects/angular/kaylios/client/src/app/notes/edit-note/edit-note.component.scss", "SCSS", 0, 0, 0, 0, 0, 0, 1, 1
"/Users/darrellparkhouse/projects/angular/kaylios/client/src/app/notes/edit-note/edit-note.component.spec.ts", "TypeScript", 17, 0, 0, 0, 0, 0, 5, 22
"/Users/darrellparkhouse/projects/angular/kaylios/client/src/app/notes/edit-note/edit-note.component.ts", "TypeScript", 8, 0, 0, 0, 0, 0, 3, 11
"/Users/darrellparkhouse/projects/angular/kaylios/client/src/app/notes/notes-list/notes-list.component.html", "HTML", 0, 1, 0, 0, 0, 0, 1, 2
"/Users/darrellparkhouse/projects/angular/kaylios/client/src/app/notes/notes-list/notes-list.component.scss", "SCSS", 0, 0, 0, 0, 0, 0, 1, 1
"/Users/darrellparkhouse/projects/angular/kaylios/client/src/app/notes/notes-list/notes-list.component.spec.ts", "TypeScript", 17, 0, 0, 0, 0, 0, 5, 22
"/Users/darrellparkhouse/projects/angular/kaylios/client/src/app/notes/notes-list/notes-list.component.ts", "TypeScript", 8, 0, 0, 0, 0, 0, 3, 11
"/Users/darrellparkhouse/projects/angular/kaylios/client/src/app/notes/notes-table/notes-table.component.html", "HTML", 0, 1, 0, 0, 0, 0, 1, 2
"/Users/darrellparkhouse/projects/angular/kaylios/client/src/app/notes/notes-table/notes-table.component.scss", "SCSS", 0, 0, 0, 0, 0, 0, 1, 1
"/Users/darrellparkhouse/projects/angular/kaylios/client/src/app/notes/notes-table/notes-table.component.spec.ts", "TypeScript", 17, 0, 0, 0, 0, 0, 5, 22
"/Users/darrellparkhouse/projects/angular/kaylios/client/src/app/notes/notes-table/notes-table.component.ts", "TypeScript", 8, 0, 0, 0, 0, 0, 3, 11
"/Users/darrellparkhouse/projects/angular/kaylios/client/src/app/notes/notes.component.html", "HTML", 0, 1, 0, 0, 0, 0, 1, 2
"/Users/darrellparkhouse/projects/angular/kaylios/client/src/app/notes/notes.component.scss", "SCSS", 0, 0, 0, 0, 0, 0, 1, 1
"/Users/darrellparkhouse/projects/angular/kaylios/client/src/app/notes/notes.component.spec.ts", "TypeScript", 17, 0, 0, 0, 0, 0, 5, 22
"/Users/darrellparkhouse/projects/angular/kaylios/client/src/app/notes/notes.component.ts", "TypeScript", 15, 0, 0, 0, 0, 0, 4, 19
"/Users/darrellparkhouse/projects/angular/kaylios/client/src/app/portfolio/portfolio-item/portfolio-item.component.html", "HTML", 0, 1, 0, 0, 0, 0, 1, 2
"/Users/darrellparkhouse/projects/angular/kaylios/client/src/app/portfolio/portfolio-item/portfolio-item.component.scss", "SCSS", 0, 0, 0, 0, 0, 0, 1, 1
"/Users/darrellparkhouse/projects/angular/kaylios/client/src/app/portfolio/portfolio-item/portfolio-item.component.spec.ts", "TypeScript", 17, 0, 0, 0, 0, 0, 5, 22
"/Users/darrellparkhouse/projects/angular/kaylios/client/src/app/portfolio/portfolio-item/portfolio-item.component.ts", "TypeScript", 8, 0, 0, 0, 0, 0, 3, 11
"/Users/darrellparkhouse/projects/angular/kaylios/client/src/app/portfolio/portfolio.component.html", "HTML", 0, 1, 0, 0, 0, 0, 1, 2
"/Users/darrellparkhouse/projects/angular/kaylios/client/src/app/portfolio/portfolio.component.scss", "SCSS", 0, 0, 0, 0, 0, 0, 1, 1
"/Users/darrellparkhouse/projects/angular/kaylios/client/src/app/portfolio/portfolio.component.spec.ts", "TypeScript", 17, 0, 0, 0, 0, 0, 5, 22
"/Users/darrellparkhouse/projects/angular/kaylios/client/src/app/portfolio/portfolio.component.ts", "TypeScript", 8, 0, 0, 0, 0, 0, 3, 11
"/Users/darrellparkhouse/projects/angular/kaylios/client/src/app/services/notes.service.spec.ts", "TypeScript", 12, 0, 0, 0, 0, 0, 5, 17
"/Users/darrellparkhouse/projects/angular/kaylios/client/src/app/services/notes.service.ts", "TypeScript", 7, 0, 0, 0, 0, 0, 3, 10
"/Users/darrellparkhouse/projects/angular/kaylios/server/controllers/notes.controller.js", "JavaScript", 0, 0, 0, 27, 0, 0, 8, 35
"/Users/darrellparkhouse/projects/angular/kaylios/server/controllers/user.controller.js", "JavaScript", 0, 0, 0, 78, 0, 0, 22, 100
"/Users/darrellparkhouse/projects/angular/kaylios/server/database/db.sql", "SQL", 0, 0, 0, 0, 8, 0, -2, 6
"/Users/darrellparkhouse/projects/angular/kaylios/server/routes/notes.js", "JavaScript", 0, 0, 0, 9, 0, 0, 2, 11
"Total", "-", 247, 53, 50, 114, 8, 6, 118, 596